R 1920 1024

SO ./textures/south.xpm
WE ./textures/west.xpm
EA ./textures/east.xpm
NO ./textures/north.xpm

S ./textures/sprite.xpm

C 117,187,253
F 53,125,45

                    1111111111111111111111111111111111111
                    1000000000000000011000000000000000021
                    1011000000000000111000000002000000001
                    1001000020000000000000000000000000001
111111111111111111111011000000000000111000000000000000001
120000000000000000000011000000000000111000111111111111111
111011111111111111111111111111110111000000000000000100001
111011111111111111111111111111110111000000000000000100001
110000000000000001101211111111110111000002000000000100001
100000000200000001101011111111110111000000000000000100001
100000000000000000000000000000000000000000000000000000001
100000011111100000000000000000000000000000000000000000001
10000001    100000002000000000000000000000002000002000001
11000001    100000E00000000000000000000000000000000000001
11100001    100000000000000000000000000000000000000000001
111100011111111111111111111111111111111111111111111111111
11110000111
11110220111
11111111111
