R 1920 1080

SO ./path_texture
WE ./path_texture
EA ./path_texture
NO ./path_texture

S ./path_sprite
F 220,100,0
C 225,30,0


                    1111111111111111111111111111111111111
                    1000000000000000011000000000000000000
                    1011000000000000111000000002000000001
                    1001000000000000000000000000000000001
111111111111111111111011000000000000111000000000000000001
100000000000000000000011000000000000111011111111111111111
111011111111111111111111111111110111000000000000000100001
111011111111111111111111111111110111000000000000000100001
110000000000000001101011111111110111000000000000000100001
100000000200000001101011111111110111000000000000000100001
100000000000000000000000000000000000000000000000000000001
100000011111100000000000000000000000000000000000000000001
10000001    100000002000000000002000000000002000000000001
11000001  0 100000000000000000000000000000000000000000011
11100001    100000000000000000000000N00000000000000000111
111111111111111111111111111111111111111111111111111111111
11110000111
11110000111
11111111111